XXXXXXXXXXXXXXXXXXXXXXXXXX
X2a3X131X3431X324c3213123X
X134X4b1X1231X14212334231X
X1231XXX131213XXXXXX13124X
X142124X5222314234X134252X
X522431X1341212111X524212X
X13124X2522341X4121342131X
X12312341231X1313d1241X21X
X31341X121342132312131431X
X4121313412131321X1312141X
XXXXXXXXXXXXXXXXXXXXXXXXXX